TTTTTTTTTTTTTT
T    T   R T T
T RX TTTTTTTTT
T    TTT XXXXT
T   R TTX    T
T    TTT XXX T
T    TTT    XT
T  RTTTTXXXX T
TTTTTTTTTTTTTT